10
10
2
==========
=        =
=   O    =
=   B    =
=   X    =
=   B    =
=   O    =
=        =
=        =
==========